11 11 11 11 11 11 11 0 11 5 5 4 9 19 18 17
11 0 0 0 0 1 1 0 11 11 11 11 11 11 8 16
11 1 1 1 1 1 1 1 2 0 0 0 0 11 4 5
11 0 0 1 0 0 0 0 2 0 0 2 0 11 11 11
11 0 2 0 0 1 1 1 2 0 0 2 0 2 0 11
11 0 0 2 0 1 1 1 2 0 0 2 0 0 0 11
11 0 0 2 0 0 1 1 2 1 0 2 0 0 0 11
11 0 0 0 0 0 1 1 2 1 1 0 1 2 0 11
11 0 0 0 0 0 0 0 2 0 14 14 14 14 14 20
11 0 0 0 6 6 6 1 2 2 14 13 14 14 14 20
11 0 0 6 6 6 6 6 0 2 14 13 20 20 20 20
11 11 11 11 6 6 6 11 11 11 13 13 20 20 20 20