0 0 0 0 0 0 0 0 10 0 0 0 0 0 0 0
0 0 0 0 0 1 1 0 10 0 0 2 0 4 4 0
5 5 5 5 5 5 5 5 9 5 5 5 0 4 0 0
0 0 0 1 0 0 0 0 9 0 0 5 0 4 3 3
0 0 2 12 0 1 1 1 9 0 0 5 0 3 0 0
0 0 0 2 0 1 1 1 9 0 0 5 0 0 0 0 
0 0 0 2 0 0 1 1 9 1 0 5 5 5 0 0 
0 0 0 0 0 0 1 1 9 1 1 0 1 5 0 0
0 0 0 0 0 0 0 0 9 0 0 0 0 0 4 0 
0 0 0 0 6 0 0 1 9 9 0 0 0 0 4 0
0 0 0 0 6 0 0 1 0 9 0 12 12 12 12 12
0 0 0 0 6 0 0 0 0 9 0 12 12 12 12 12